###############################
#              ##      ##     #
#                  ##      #  #
#  ######  ##### ###########  #
#  #                          #
#         ###  ##### ###  #####
#  #                 #        #
#  #           #  #  #######  #
#              #              #
###############################